-N-
W  E
|   |
|    |
|    ------
|   c     |
|    t    |
|         |
---S-------