---N-----
| t   | |
|     | |
W   c   E
|       |
| |     |
| |   t |
---S-----