---N-----
|       |
|   t   |
W   c   E
|   t   |
|   t   |
|       |
---S-----