---N----
W      |
|--t   |
|--c   |
|    --|
|   t--|
|      E
---S----