------N----
|         |
W   ct    E
|         |
---S-------